20 30
.###..####.......##
.....########......
...................
...................
.###..........#####
.......###.........
..#................
...................
...................
.......#######...##
.###...............
...................
...................
...................
.###..####.......##
.....########......
...................
...................
.###..........#####
.......###.........
...................
...................
...................
...................
################...
...................
....###############
...................
...................
##......###########
obstacle 32 32 d
obstacle 64 64 u
obstacle 256 312 l
obstacle 76 312 l
character 128 32 l
enemy 128 83 r
enemy 128 280 d
